Uma	Shankar
Sriram	Selvakumar
Mohamed	Mohamed
Cole	Miller
Amar	Waraich
Om	Kudtarkar
Saanvi	Shreesha
Kevin	Wang
Alexander	Shtov
Elliot	Tregoning
Andrew	Chen
Clarisse	Aruino
Vineet	Sunkavalli
Iuliia	Iliuk
Shriram	Rajasekar
Alan	Chen
Trina	Nguyen
Malcolm	Alvarez
Abhishek	Govindarasu
Willie	Jiang
Mira	Kapadia
Daniel	Nelson
Jay	Vishwarupe
Hannes	Ojala
Jared	Weinstein
Sergei	Litovchenko
Pruthvi	Innamuri
Emily	Ng
Faizaan	Shaikh
Pranav	Singh
Joshanne	Chiang
Saumil	Thakore
Ola	Alsaedi
John	Do
Brian	Ma
Brandon	Tedja
Pierce	Mcgoran
Jackie	Chiang
Ian	Yao
Thomas	Ojala
Mahad	Abdulkarim
Kent	Williams
Preethi	Merugumala
Murari	Ganesan
Matthew	Culaton
Jacob	Zhang
Peter	Le
Jason	Tedja
Giacomo	Guiulfo
Vansh	Venugopal
Kevin	Arackaparambil
Manjari	Ganesan
Abelino	Espinoza
Kent	Wong
Sean	Jones
Tyler	Ng
Yash	Vij
Trent	Ikehara
Joe	Krause
Linnea_pari	Leaver
Manthan	Shah
Zachary	Hallera
Dennis	Cao
Essam	Sleiman
Randy	Sun
Daniel	Camarena
Somya	Sharma
Divya	Prakash
Madison	Avila
Santiago	Valdez
Ezekiel	Liu
Sonali	Bhattacharjee
Vivian	Phung
Vyoma	Raman
Michelle	Lim
Justin	Chow
Mihir	Tyagi
Avi	Mehra
Akshey	Deokule
William	Brand
Ethan	Dinapoli
Laine	Miller
Eliot	Vanheumen
Warren	Fung
Jake	Delgado
Pratyush	Vasan
Connor	Sinclair
Neil	Chulani
Isaac	Li
Eileen	Lin
Akshay	Namburi
Rahul	Champaneria
Aaryan	Singh
Sriram	Nagasuri
Pranav	Damal
Brandon	Darby
Alexander	Sosnov
Shayan	Panjwani
Alicia	Tsung
Manar	Mohamed
Jonathan	Man
Sasha	Kononova
Timothy	Brand
Alan	Do
Qiqi	Liang
Alexander	Xie
Nyalie	Sinclair
Meo	Leung
Jay	Nathan
Vidushika	Vij
Julia	Garrido
Malvee	Vasan
Jasmin	Anguiano
Akshitha	Nagaraj
Ian	Darby
Abishek	Saokar
Paul	Truong
Julia	Kononova
Peter	Nguyen
Odin	Eriksen
Calvin	Lim
Nhi	Ho
Rohan	Tibrewal
Samuel	Collet
Aaran	Guha
Anmol	Kapoor
Helen	Deng
Mingyun	Kim
Gaetan	Juvin
Denton	Tuiasosopo
Cesar	Rico
Aaryan	Divate
Sungum	Sogani
Chinmay	Bansal
Ian	Mcnamara
Kai	Drumm
Tony	Hendrick
Rohan	Taitriya
Chloe	Chan
Armaan	Kapoor
Chasya	Oba
Brayden	Dinapoli
Raynay	Ramirez
Vindhya	Shigehalli
Rayyan	Shaikh
Isaac	Chang
Justin	Qiu
Aleesa	Ivanov
Adarsh	Bulusu
Sahil	Sandhu
Shivani	Ahuja
Samuel	Vu
Jacob	Culaton
Vjai	Thiara
Mamadi	Diawara
Luca	Herden
Kevin	Zhang
Nickolas	Mayfield
Heli	Champaneria