Ethen	Cao
Paul	Truong
Jackie	kuang
Akshey	Deokule
Dennis	Cao
Om	Kudtarkar
Andrew	Yu
Samuel	Vu
Edward	Nguyen
Aaryan	Divate
Akhil	Devarasetty
Soham	Rajadhyaksha
Eric	Tran
Prachi	Karadkar
Abhishek	Govindarasu
Pranav	Damal
RISHABH	POIKAYIL
Sonali	Bhattacharjee
Joshua	Zhong
Rithvik	Mungara
Avnish	Kovi
Romir	Kant
Sukrith	Raman
Matthew	Sydoruk
Winston	Saelinh
Lena	Munad
Heba	Munad
Aatish	Lobo
Karan 	Patel
Kipling	Liu
William	Lau
Ania	Shah
Aman	Gupta
Param	Mehta
William	Wong
Pranav	Dulepet
safah	mehdavi
Harish	Rajan
Soam	Desai
Kevin	Wang
Vindhya	Shigehalli
Cameron	Tabije
Victor	Auyeung
Ashton Neo	See
Pranit	Panda
Michael	Shahtout
David	Martinez
Mihir	Joshi
Aryan	Maheshwari
Andrew	Li
Aldrige	Tongson
Rohan	Penmatcha
Ahmed	Khan
Shivam	Adeshara
Kavish	Kartha
Lakshana	Viswa
Joshua 	Gatus
Aditya	Mangalampalli
Jason 	Sung
Juhi	Dalal
Ivan	Dy
Maanuj	Vora
Shaurya	Srivastav
Simaal	Belgaumi
Samik	Pradhan
Priya	Talreja
Anuj	Kothari
Paulina	Gutierrez
Reva	Jariwala
Pujan	Tewari
Nick	Jajeh
Ritwik	Sharma
Nancy	Nguyen
Tanishq	Patil
Tristan	Huang
Rohan	Karra
Param	Mehta
Khushi 	Singh
Genesis	Hautau
Cheyenne 	Garza
TRISHA	GANESH
Serena	Ghuman
Jake	delgado
Cleo	Chow
Arushi	Arora
Anish	Gupta
Tristan	Goutain
Justin	park
Shreyas	Shrestha
Isaac	Cuevas
William	Lin
Dilsher	Dhaliwal
Eunice	Oh
Shreya	Parikh
Christina	Liu
Hisham	Seddiqee
Charlotte	Chin 
Pranav	Dharuri
Damon	Johnson
Laurent	Yu
Linnea	Leaver
Neha	Yadav
Juhi	Yadav
Krishna	Ramesh
BRANDON	NHIN
RAYMOND 	PHUNG
Lukas	Morris
Oleg	Mrynskyi
Nathan	Pham
Talon 	Pham
Ishika	Agarwal
Krish	Agarwal
Neil	Rustagi
Laron	Morris
Matthew	Cho
Isaac	Li
Avery	Li
Gayatri	Rithe
Sanjana	Shinde
TANISHQ	SHINDE
Ishan	Madan
Chloe	Chen
Maxim	Puhoff
Nathan	Holmes-King
Joey	Lee
Elton	Lee
Kalven	Guiang
Aakash	Bathini
Ricardo	Carrasco
Violeta	Druga
Michael 	Luk
Sahil	Mehta
Jack	Hitching
Caleb	Yonas
anastasia	washington
Chris	Raynes
Manik	Sethi
Daniel	Vivian
Harshini	Jayaprakash
Amar	Waraich
Anya	Sengupta
Fatima 	Diawara
Mamadi 	Diawara
Riya 	Parekh
Teri	Jiang
Darcy	Chew
Nihal	Mareedu
Siddharth	Paul
Wenhao	Xu
Bhumika	Iroji
Alex	Wu
Kanti	Bharat
Amanuel	Ayalew
Humzah	Baig
David	Sun
Rohan	Makkar
Dylan	Dsilva
Samarth	Bala
Sophie	Han
Aryaman	Gautam
Shriram	Rajasekar
maelle	allanic
Roland 	Zhang
Eshani 	Jha 
Darren	zhan
Samyak	Ghevaria
Trinity	Willis
Adi	Perets
Brandon	Darby
Avi	Mehra
Jasmine	Truong
Lucas	Stevenson
Ved	Patel
Ves	Patel
Tanvi	Deshpande
Yael 	Sanchez
Karan	Gandhi
Suhani	Arora
MAMADOU	BAH
DJEINABOU	BAH
Ronin	Fife
Akul	Shourie
Sakshi	Thakral
Anjali	Chandna
Trishla 	Mehta 
Roshini	Pulle
Tehya	Garza
Wanli	Li
Aron	Thakur
Tarun 	Nair
Annie	Chen
Arnav	Pradhan
Mark	Kousnetsov
Maxim	Kousnetsov
Amir	Sepasian
Netra	Yadav
Sanjay	Kumar
Harshil	Shah
Ashwin	Chembu
Maitri	Parikh
Shubham	Shroff
Shreya	Sanapala
Cristian	Chavez
Christopher 	Lu
Miguel	Vasquez
Aleksandr	Khvatov
Guillermo	Molina
Alonso	Corral
Alex	Asay
Yasamin	hakimi
Apollo	Heo
Trinity	Cooper 
Anish	Chakrabarty
Sandy	Sanchez
Rominna	Sharifi
Sheza	Saiyed
Christopher	Grethen
Jeremy	lei
Darshana Saravanan
Kyle	Fu
Eugenia	Cho
Nathaniel	Lao
Felix	Ohlgart
Mattias	Larsson
Rishab	Koka